#############
##         ##
## .   # ####
##     ######
#############
8 2
4 2