######################
##############    ####
#####            .####
#####     # ##   .####
#####     ############
######################
11 2
7  2
12 3