########
###   ##
#   # ##
# #  . #
#    # #
## #   #
##   ###
########
2 1
2 5