##########
#.....  ##
###   # ##
###  ##  #
###      #
###   #  #
####  #  #
##########
8 1
3 3
5 3
7 3
4 4
4 5
