######
#.. .#
#.  .#
##   #
##  ##
#   ##
##  ##
######
2 2
3 2
2 3
3 4
2 5
3 6
