#########
#  ...  #
#       #
##     ##
###   ###
#########
4 1
3 3
4 3
5 3