######
# .###
#. ###
#    #
#    #
#  ###
######
2 3
3 2
1 3