#######
#     #
# . . #
#  .  #
# . . #
#  .  #
#     #
#######
3 1
2 2
4 2
3 3
2 4
4 4
3 5