########
### .. #
###    #
#### ###
#### ###
#### ###
#### ###
#    ###
# #   ##
#   # ##
###   ##
########
6 10
5 9
4 9