######
#.   #
#    #
##   #
###  #
####.#
######
1 4
2 4
3 4
