###########
#######.  #
#######.# #
#######.# #
#         #
# # # # ###
#       ###
###########
2 3
4 3
6 3
8 3