##########
#        #
#        #
# ##.### #
# #    . #
# .   ## #
#####    #
##########
4 2
5 2
4 3
5 3