###############
#     #    ####
#.##  # ##  ###
#   #     #  ##
#   # ###  #  #
# #      #  # #
# # ####  # # #
#.        . . #
###############
3 1
8 1
10 1
1 4
7 6