############
####  ######
####  ######
##    ######
#   # ######
# #   ######
# #   #   .#
#         .#
###  ### ..#
############
6 2
3 2
3 4
4 4
4 7