###############
###############
######  #######
##      #######
## ## ..#  ...#
#     #       #
#        ###  #
#######  ######
###############
10 3
2 3
4 3
5 3
7 3
7 5