##########
##  ######
#     ####
##    ####
##  ######
##   ....#
##  # ####
### # ####
##  # ####
##    ####
##  ######
##########
1 9
2 9
4 8
4 6
3 3