###############
###############
#     #   #####
# #..     #####
#  #..# #######
##  ##        #
###           #
###############
6 4
7 2
8 2
10 2
12 2