############
########   #
#.   .   #.#
#  ###     #
##         #
##     #####
##  #  #####
### #  #####
###   ######
############
8 7
3 3
3 4
3 5