#########
#   #  ##
#.     ##
#.  #  ##
#.  #   #
#.  #   #
#   #   #
#########
2 6
2 5
2 3
5 4
5 2