###################
#    #######  #####
#    #  #     #   #
#          #      #
##      #  #      #
#    ########### ##
# #   #.......#  ##
# ##  # ......#  ##
# #    ........  ##
# #   #.... ..#  ##
#     #### ####  ##
#     ###        ##
#                 #
## ######   ##### #
#         #       #
###################
10 11
7 9
8 9
9 9
10 9
11 9
12 9
13 9
8 8
9 8
10 8
11 8
12 8
13 8
6 7
8 7
9 7
10 7
11 7
12 7
13 7
14 7
7 6
8 6
9 6
10 6
12 6
13 6
LLLLLLLULLLLLDDDDDDURRRRRRRULRULDURLDURDLRUDLRDURLUDURLDR
