###################
#######..    #   ##
######...        ##
#####....# # #  ###
####....# # #    ##
####...#  #    # ##
#  ## #          ##
#      ###  #   ###
#         # #   ###
###     # # # # ###
###       # # #####
###  # #####      #
###    #####    # #
###  ########     #
###  ########    ##
###################
2 8
7 14
8 14
6 13
7 13
8 13
5 12
6 12
7 12
8 12
4 11
5 11
6 11
7 11
4 10
5 10
6 10
LUDRULDURLDURDUUUUUURDDDDDDDDLLLLLLLLLL
