################
###  ###########
###            #
###  #   #     #
###       #    #
###  # #  #### #
# #       ##   #
#      # #   # #
#              #
#####  #########
###      #######
###      #######
###......#######
###......#######
###......#######
################
1 9
3 3
4 3
5 6
6 6
7 3
8 3
3 2
4 2
5 2
6 2
7 2
8 2
3 1
4 1
5 1
6 1
7 1
8 1
DDDDDDDRRRRDDDDDDDDDDDDUUUUUUUUUUUUUUUUUUUUUURDDDDDDDDDDDDDDDDDDDDDDDDDDDD
