##############
#..  #     ###
#..  #       #
#..  # ####  #
#..      ##  #
#..  # #    ##
###### ##    #
###          #
###    #     #
##############
3 1
1 4
1 5
1 6
1 7
1 8
2 4
2 5
2 6
6 3
3 7
URRRUUDDRRRUULULLLLLUULRDDDLUUUUUURUL