#################
#########      ##
#########  #  ###
#########     ###
##########    ###
#########   # ###
#....  ##       #
##...           #
#....  ##########
#################
14 8
1 1
1 3
2 1
2 2
2 3
3 1
3 2
3 3
13 4
5 1
9 3
LDDDDDRDLLLLLLLLLLLLLRDLURRRRRUULDRDLLLLDLUURUL