################
###  ###########
###            #
###  #   #     #
###       #    #
###  # #  #### #
# #       ##   #
#      # #   # #
#              #
#####  #########
###      #######
###      #######
###......#######
###......#######
###......#######
################
1 9
7 13
11 13
13 13
4 12
7 12
12 12
5 11
7 11
4 10
3 9
5 9
7 9
5 8
8 8
4 7
9 7
11 7
13 7
DDRRRRDDLDDRUUUUUURRDDDLLLLLLUURRRUUU