###################
############  ....#
############  ....#
#    #        ....#
#    #     #  ....#
#          #  ....#
#    #     ########
#    #     ########
## ################
#    #    #########
#         #########
#    #     ########
#    #    #########
###################
10 2
14 8
15 8
16 8
17 8
14 9
15 9
16 9
17 9
14 10
15 10
16 10
17 10
14 11
15 11
16 11
17 11
14 12
15 12
16 12
7 2
LLDLURULLLLLDLUUUUUUULURR