##############
#..  #     ###
#..  #       #
#..  # ####  #
#..      ##  #
#..  # #    ##
###### ##    #
###          #
###    #     #
##############
7 5
7 7
10 7
6 6
10 4
9 3
11 3
4 2
7 2
9 2
11 2
