###################
############  ....#
############  ....#
#    #        ....#
#    #     #  ....#
#          #  ....#
#    #     ########
#    #     ########
## ################
#    #    #########
#         #########
#    #     ########
#    #    #########
###################
10 2
8 10
10 10
2 9
3 9
4 9
6 9
9 9
3 8
9 8
2 7
3 7
6 7
8 7
10 7
3 6
6 3
3 2
4 2
6 2
7 2
