#################
#########   #####
######### # ##  #
#########       #
######### ###   #
#....  ##     ###
#....         ###
#....  ##      ##
#########     ###
#########      ##
########### ## ##
###########    ##
#################
14 5
11 10
14 9
10 7
13 7
9 6
11 6
12 6
9 5
12 5
11 4
10 3
12 3
