############
#..  #### ##
#..  ###   #
#..        #
#..  # #   #
#..### #   #
####   #   #
####   #   #
####       #
####  ##   #
############
9 9
8 7
9 7
9 6
9 5
5 4
8 4
6 3
9 3
5 2
8 2
