#############
########   ##
## #  ##    #
#           #
#     ###   #
### ##### ###
#    ### ..##
#       ...##
#    ###...##
#    ###...##
#  ##########
#############
5 9
9 9
10 9
5 8
3 7
9 6
2 5
2 4
4 4
6 4
2 2
3 2
