#################
###########  ...#
###########  ...#
#######      . .#
#######  ##  ...#
######## ##  ...#
######## ########
######     ######
######      #####
##   #      #   #
#               #
######      #####
######      #####
#################
1 3
7 6
8 6
9 6
8 5
10 5
6 4
8 4
3 3
6 3
11 3
14 3
7 2
8 2
10 2
