#################
#              ##
# # ######     ##
# #         #  ##
# #         ## ##
# #       ###...#
# #        ##...#
# ###      ##...#
#     # ## ##...#
#####   ## ##...#
#########     ###
#########     ###
#################
7 8
5 9
7 9
9 9
11 9
6 8
8 8
5 7
7 7
9 7
6 6
8 6
5 5
6 5
7 5
9 5
