###################
####   ##  ########
###     #  #    ###
#    #  #  #  ... #
# #  #  ## # #.#. #
#  # #   #    . . #
#        # # #.#. #
#   ##  ##    . . #
#   #   #  # #.#. #
##            ... #
##  ######    ##  #
##  ###############
###################
6 8
3 9
6 9
4 8
7 8
6 7
2 6
7 6
10 5
12 5
2 4
12 4
3 3
6 3
10 3
13 3
2 2
