##################
########     #####
##     #     #####
##   #   #########
## ###......##   #
##    ......## # #
## ###......     #
##   #### ### # ##
#  #    #     # ##
#         #  ## ##
#       ###   # ##
#####         # ##
####### ###   # ##
#######     #   ##
##############  ##
##################
10 13
9 13
11 13
2 12
3 12
5 10
15 8
4 7
11 7
3 6
5 6
6 6
7 6
12 6
4 5
6 5
11 5
12 5
10 4
