##############
#   ##########
#    #########
#    ####  ###
#          ###
###  #     ###
##  ##      ##
##    ## ## .#
##  # ##   #.#
####    ..##.#
###    #.....#
###    #.....#
###  #########
###  #########
##############
3 9
2 11
3 10
4 10
6 10
10 10
6 9
8 8
10 8
3 7
5 6
8 6
7 5
9 4
4 3
5 3
