###################
######  .  #   ####
###### #.      ####
###### ##..# ######
##  # ..###     ###
#   #...     #    #
#    .. ##  ## ## #
#### ## #   #   # #
#### #    #     # #
###    # #  #  ## #
###               #
###  ###########  #
###################
13 10
2 7
11 7
16 7
4 5
7 5
10 5
11 4
13 4
14 4
5 3
14 3
