###################
###    ############
#####     #########
#   ##    #########
#   #  ##    ######
#   #  ##### ######
##         # ######
##     ### # ######
## #     # # ######
## # # #   # ######
## ###   # # ######
#     #### # #....#
#             ..#.#
####    #     ....#
#       #  ## ....#
###################
6 14
6 13
2 11
2 10
3 9
6 9
3 8
5 8
6 7
6 6
3 4
5 3
10 3
4 2
7 2
10 2
