###################
#####        ######
#     #      #  ###
# ####### ####  ###
# #    ## #  #  ..#
# #       #  #  #.#
# #    #     #  ..#
# #  ### ##     #.#
# ###  #  #  #  ..#
# #    #  ####  #.#
# #          #  ..#
#      #     #  #.#
####  ###    #  ..#
####       ###....#
####      #########
###################
14 13
10 13
9 12
14 11
4 10
4 9
14 9
14 7
3 5
7 5
10 5
14 5
5 4
9 4
11 4
5 3
14 3
8 2
9 2
