###################
#####  #  #########
#####  #  #  ######
#.. #  #  #   #####
#.. #  #  #   #####
#.  #     #   #  ##
#..    #  #      ##
#.. #  #  #   #  ##
#.. #  #      #  ##
#.. #  #  #   #  ##
#.. #  #  #   #   #
#.. #  #  #   #   #
##. ####  #####   #
###################
3 6
6 11
8 11
6 9
8 9
13 9
11 8
6 7
12 7
8 6
11 6
6 5
13 5
8 4
9 4
11 4
6 3
13 3
15 3
