###################
########   #     ##
########         ##
#   #####  ## # ###
#   ##   # ##    ##
#        # ##    ##
## ###   # ##    ##
## #   ### ##### ##
## #        #....##
#  ### ##   #....##
#       #   #.. . #
#  ##   #  ##.... #
#####   ######...##
###################
5 8
13 11
15 11
10 10
2 9
14 9
2 8
6 8
7 8
13 8
14 8
15 8
16 6
9 5
10 4
2 3
6 3
15 3
6 2
