###################
#   #    # ###....#
#     #      .....#
#   # ###   # ....#
## ## ###  #  ....#
##         # # ####
##     ##  #      #
#### #  #### # ## #
#  # #    ## #    #
#       # ## #   ##
# #        # #   ##
#    ## ## # ######
#            ######
## ## ###    ######
##    ###    ######
###################
10 13
4 13
5 13
3 10
5 10
4 9
6 9
6 7
2 6
5 6
4 5
6 5
3 4
2 3
3 3
9 3
10 3
10 2
