###################
############   ####
###########     ###
##########      ###
#########       ###
########        ###
########      #####
#  ######## ##    #
#.                #
#.# ####### ##   ##
#.# #######. #   ##
#........... #    #
##############    #
###############  ##
###################
17 6
12 11
13 11
10 10
11 10
14 10
9 9
14 9
11 8
12 8
14 6
15 6
16 6
14 4
16 4
16 2
