##################
######      ######
###    ##        #
### ## ## #     ##
### ......#     ##
#   ......#  #   #
# # ......#      #
# # ......   #   #
#   ### ###     ##
###             ##
###             ##
########   #######
##################
16 10
10 10
12 10
9 9
11 9
13 9
15 9
13 8
14 8
11 6
14 6
3 5
11 5
12 5
15 5
11 4
14 4
5 3
8 3
11 3
14 3
5 2
8 2
11 2
14 2
