###################
#########  #  #####
#####   #        ##
##### #   ## ##  ##
##      # #  ## ###
#  ###  #         #
#...    # ##  #   #
#...#      # ### ##
#...#  ###        #
###########   #   #
###################
9 3
12 8
7 7
8 7
7 5
9 5
12 5
15 5
12 2
15 2
