################
#...###  #######
#...###     ####
#....##     ####
##....##      ##
###... ##     ##
# ##    #     ##
#  ## # ### ####
#   # #        #
#              #
#   #        ###
#  ######  #####
# ##############
################
5 4
9 11
8 10
11 10
11 9
10 8
12 8
11 7
2 5
7 5
10 5
3 4
7 4
12 4
6 3
8 3
9 3
11 3
