##############
#        #####
# ###### #  ##
# #          #
#       #    #
###     #  ###
###  ## #  ###
#### #      ##
####      ####
#### #      ##
#### ##   # ##
####  ##### ##
###         ##
###.......####
###.......####
##############
11 8
4 12
6 12
8 12
11 12
9 11
3 10
6 10
7 10
10 9
4 8
9 8
6 7
8 7
9 6
