###################
#######..    #   ##
######...        ##
#####....# # #  ###
####....# # #    ##
####...#  #    # ##
#  ## #          ##
#      ###  #   ###
#         # #   ###
###     # # # # ###
###       # # #####
###  # #####      #
###    #####    # #
###  ########     #
###  ########    ##
###################
2 8
8 13
10 13
15 13
7 12
15 12
6 11
14 11
3 8
5 8
2 7
6 7
3 6
4 6
6 5
4 4
3 3
